Here is a list for Monotype PostScript fonts.

mair	MAbadi
maib	MAbadi-Bold
maibi	MAbadi-BoldItalic
maix	MAbadi-ExtraBold
maixi	MAbadi-ExtraBoldItalic
maii	MAbadi-ExtraLight
maiii	MAbadi-ExtraLightItalic
mairi	MAbadi-Italic
mail	MAbadi-Light
maili	MAbadi-LightItalic
mairrc	AbadiMT-Condensed
maibrc	AbadiMT-CondensedBold
maixrc	AbadiMT-CondensedExtraBold
mailrc	AbadiMT-CondensedLight
malr	AlbertusMT
malri	AlbertusMT-Italic
mall	AlbertusMT-Light
ma2r	AmasisMT
ma2c	AmasisMT-Black
ma2ci	AmasisMT-BlackItalic
ma2b	AmasisMT-Bold
ma2bi	AmasisMT-BoldItalic
ma2ri	AmasisMT-Italic
ma2l	AmasisMT-Light
ma2li	AmasisMT-LightItalic
ma2m	AmasisMT-Medium
ma2mi	AmasisMT-MediumItalic
mapr	MApollo
mapri	MApollo-Italic
maps	MApollo-SemiBold
% Arial is Monotype's name for Helvetica.
mhvr	ArialMT
mhvc	ArialMT
mhvci	ArialMT-BlackItalic
mhvb	ArialMT-Bold
mhvbi	ArialMT-BoldItalic
mhvrc	ArialMT-Condensed
mhvbrc	ArialMT-CondensedBold
mhvxrc	ArialMT-CondensedExtraBold
mhvlc	ArialMT-CondensedLight
mhvx	ArialMT-ExtraBold
mhvxbi	ArialMT-ExtraBoldItalic
mhvri	ArialMT-Italic
mhvl	ArialMT-Light
mhvli	ArialMT-LightItalic
mhvm	ArialMT-Medium
mhvmi	ArialMT-MediumItalic
mhvrrn	MArial-Narrow
mhvbrn	MArial-NarrowBold
mhvbin	MArial-NarrowBoldItalic
mhvrin	MArial-NarrowItalic
mahr	AshleyScriptMT
magkf	MAvantGardeGothicPS-Book
magkfo	MAvantGardeGothicPS-BookObl
magdf	MAvantGardeGothicPS-Demi
magdfo	MAvantGardeGothicPS-DemiObl
mbvr	BaskervilleMT
mbvb	BaskervilleMT-Bold
mbvbi	BaskervilleMT-BoldItalic
mbvri	BaskervilleMT-Italic
mbvs	BaskervilleMT-SemiBold
mbvsi	BaskervilleMT-SemiBoldItalic
mbvrx	MBaskervilleExpert
mbvbx	MBaskervilleExpert-Bold
mbvbix	MBaskervilleExpert-BoldItalic
mbvrix	MBaskervilleExpert-Italic
mbvsx	MBaskervilleExpert-SemiBold
mbvsix	MBaskervilleExpt-SemiBoldIta
mber	MBell
mbeb	MBell-Bold
mberi	MBell-Italic
mbes	MBell-SemiBold
mbbr	Bembo
mbbb	Bembo-Bold
mbbbi	Bembo-BoldItalic
mbbx	Bembo-ExtraBold
mbbxi	Bembo-ExtraBoldItalic
mbbri	Bembo-Italic
mbbs	Bembo-Semibold
mbbsi	Bembo-SemiboldItalic
mbbrx	MBemboExpert
mbbbx	MBemboExpert-Bold
mbbbix	MBemboExpert-BoldItalic
mbbxx	MBemboExpert-ExtraBold
mbbxix	MBemboExpert-ExtraBoldItalic
mbbrix	MBemboExpert-Italic
mbbsx	MBemboExpert-SemiBold
mbbsix	MBemboExpert-SemiBoldItalic
mbnrrc	BernardMT-Condensed
mbfr	BiffoMT
mb2r	BinnyOldStyleMT
mb2ri	BinnyOldStyleMT-Italic
mb1ri	MBlado-Italic
mbdr	BodoniMT
mbdb	BodoniMT-Bold
mbdbi	BodoniMT-BoldItalic
mbdri	BodoniMT-Italic
mbdc	MBodoni-Black
mbdci	MBodoni-BlackItalic
mbdbrc	MBodoni-BoldCondensed
mbdbic	MBodoni-BoldCondensedItalic
mbdk	MBodoni-Book
mbdki	MBodoni-BookItalic
mbdu	MBodoni-UltraBold
mbdui	MBodoni-UltraBoldItalic
mbkd	MBookmanPS-Demi
mbkdi	MBookmanPS-DemiItalic
mbkl	MBookmanPS-Light
mbkli	MBookmanPS-LightItalic
mb3r	MBraggadocio
mc1r	CalistoMT
mc1b	CalistoMT-Bold
mc1bi	CalistoMT-BoldItalic
mc1ri	CalistoMT-Italic
mc8b	CalvertMT-Bold
mc8l	CalvertMT-Light
mc8m	CalvertMT-Medium
mtlr	CastellarMT
murr	CentaurMT
murb	CentaurMT-Bold
murbi	CentaurMT-BoldItalic
murri	CentaurMT-Italic
murrai	CentaurMT-ItalicA
murrx	CentaurExpertMT
murbx	CentaurExpertMT-Bold
murbix	CentaurExpertMT-BoldItalic
murrix	CentaurExpertMT-Italic
murry	CentaurSwashMT
mcnb	MCentury-Bold
mcnbi	MCentury-BoldItalic
mcnrrx	MCentury-Expanded
mcnrix	MCentury-ExpandedItalic
mcur	MCenturyOldStyle
mcub	MCenturyOldStyle-Bold
mcubi	MCenturyOldStyle-BoldItalic
mcuri	MCenturyOldStyle-Italic
mcsr	MCenturySchoolbook
mcsb	MCenturySchoolbook-Bold
mcsbi	MCenturySchoolbook-BoldItalic
mcsri	MCenturySchoolbook-Italic
mncr	MCenturySchoolbookPS
mncb	MCenturySchoolbookPS-Bold
mncbi	MCenturySchoolbookPS-BoldIta
mncri	MCenturySchoolbookPS-Ita
mcdr	MtClarendon
mc6r	MClarion
mc6b	MClarion-Bold
mc6ri	MClarion-Italic
mcfbf	ClearfaceGothicMT-Bold
mcfdf	ClearfaceGothicMT-DemiBold
mcfb	ClearfaceMT-Bold
mc7b	CompactaMT-Bold
motb	CoronetMT-Bold
mcrr	MCourierPS
mcrb	MCourierPS-Bold
mcrbi	MCourierPS-BoldItalic
mcrri	MCourierPS-Italic
mcrr12	CourierTwelveMT
mdsr	DorchesterScriptMT
meer	MEgyptianExtended
metr	EhrhardtMT
metri	EhrhardtMT-Italic
mets	EhrhardtMT-SemiBold
metsi	EhrhardtMT-SemiBoldItalic
metrx	MEhrhardtExpt
metrix	MEhrhardtExpt-Italic
metsx	MEhrhardtExpt-SemiBold
metsix	MEhrhardtExpt-SemiBoldItalic
melr	MEllington
melb	MEllington-Bold
melbi	MEllington-BoldItalic
melx	MEllington-ExtraBold
melxi	MEllington-ExtraBoldItalic
melri	MEllington-Italic
mell	MEllington-Light
melli	MEllington-LightItalic
menr	EngraversMT
menb	EngraversMT-Bold
menrn	EngraversOldEnglishMT
mfsr	MFalstaff
mfxr	FelixTitlingMT
mfir	MFigaro
mfer	MForte
mgmr	GaramondMT
mgmai	GaramondMT-AlternativeItalic
mgmb	GaramondMT-Bold
mgmbi	GaramondMT-BoldItalic
mgmri	GaramondMT-Italic
mgmrx	MGaramondExpert
mgmbx	MGaramondExpert-Bold
mgmbix	MGaramondExpert-BoldItalic
mgmrix	MGaramondExpert-Italic
mgsra	GillAltOneMT
mgsba	GillAltOneMT-Bold
mgsbai	GillAltOneMT-BoldItalic
mgsrai	GillAltOneMT-Italic
mgsla	GillAltOneMT-Light
mgslai	GillAltOneMT-LightItalic
mgrb	MGloucester-Bold
mgrbc	MGloucester-BoldCondensed
mgrbx	MGloucester-BoldExtended
mgrbo	MGloucester-BoldExtraCondensed
mgrr	MGloucester-OldStyle
mgyb	MGoudyBold
mgyx	MGoudyExtraBold
mg5r	MGoudyCatalogue
mg5ri	MGoudyCatalogue-Italic
mg4r	MGoudyModern
mg4ri	MGoudyModern-Italic
mgor	MGoudyOldStyle
mgori	MGoudyOldStyle-Italic
mgtr	GoudyTextMT
mgtra	GoudyTextMT-Alternate
mgtr2	GoudyTextMT-Dfr
mgtrd	GoudyTextMT-LombardicCapitals
mgqr	MGrotesque
mgqc	MGrotesque-Black
mgqb	MGrotesque-Bold
mgqrrc	MGrotesque-Condensed
mgqrrq	MGrotesque-ExtraCondensed
mgqri	MGrotesque-Italic
mgql	MGrotesque-Light
mgqlrc	MGrotesque-LightCondensed
mgqli	MGrotesque-LightItalic
mhdr	MHeadlineBold
mhor	MHorleyOldStyle
mhob	MHorleyOldStyle-Bold
mhobi	MHorleyOldStyle-BoldItalic
mhori	MHorleyOldStyle-Italic
mhol	MHorleyOldStyle-Light
mholi	MHorleyOldStyle-LightItalic
mhosi	MHorleyOldStyle-SemiBolItalic
mhos	MHorleyOldStyle-SemiBold
miir	MImprint
miib	MImprint-Bold
miibi	MImprint-BoldItalic
miiri	MImprint-Italic
mifb	MInflex-Bold
mior	MIonic
miob	MIonic-Bold
miori	MIonic-Italic
misr	MItalianOldStyle
misb	MItalianOldStyle-Bold
misbi	MItalianOldStyle-BoldItalic
misri	MItalianOldStyle-Italic
mjnr	MJanson
mjnb	MJanson-Bold
mjnbi	MJanson-BoldItalic
mjnri	MJanson-Italic
mjor	JoannaMT
mjob	JoannaMT-Bold
mjobi	JoannaMT-BoldItalic
mjox	JoannaMT-ExtraBold
mjori	JoannaMT-Italic
mjos	JoannaMT-SemiBold
mjosi	JoannaMT-SemiBoldItalic
mklr	MKlang
mlirrc	LatinMT-Condensed
mmeb	MercuriusScriptMT-Bold
mm1r	MonolineScriptMT
mmob	MModern-Bold
mmobi	MModern-BoldItalic
mmor	MModernExtended
mmori	MModernExtended-Italic
mnkr	NeographikMT
mnrr	NewBerolinaMT
mnnr	MNewClarendon
mnnb	MNewClarendon-Bold
mngr	NewsGothicMT
mngb	NewsGothicMT-Bold
mngrrc	NewsGothicMT-Condensed
mngbrc	NewsGothicMT-CondensedBold
mngri	NewsGothicMT-Italic
mnpr	NewsPlantinMT
mnpb	NewsPlantinMT-Bold
mnpbi	NewsPlantinMT-BoldItalic
mnpri	NewsPlantinMT-Italic
mnir	NimrodMT
mnib	NimrodMT-Bold
mnibi	NimrodMT-BoldItalic
mniri	NimrodMT-Italic
movr	OctavianMT
movri	OctavianMT-Italic
moer	MOldEnglishText
mosr	MOldStyle
mosb	MOldStyle-Bold
mosbi	MOldStyle-BoldItalic
mosbl	MOldStyle-BoldOutline
mosri	MOldStyle-Italic
moxr	MOnyx, OnyxMT
mp1r	PalaceScriptMT
mp2r	PepitaMT
mppr	Perpetua
mppb	Perpetua-Bold
mppbi	Perpetua-BoldItalic
mppri	Perpetua-Italic
mpprd	PerpetuaTitlingMT
mppbd	PerpetuaTitlingMT-Bold
mppld	PerpetuaTitlingMT-Light
mpprx	MPerpetuaExpert
mppbx	MPerpetuaExpert-Bold
mppbix	MPerpetuaExpert-BoldItalic
mpprix	MPerpetuaExpert-Italic
mphr	PhotinaMT
mphb	PhotinaMT-Bold
mphbi	PhotinaMT-BoldItalic
mphri	PhotinaMT-Italic
mphs	MPhotina-SemiBold
mphsi	MPhotina-SemiBoldItalic
mphu	MPhotina-UltraBold
mphui	MPhotina-UltraBoldItalic
mpdbrc	MtPlacard-BoldCondensed
mpdrrc	MtPlacard-Condensed
mpilx	MPlantinExpt-Light
mpilix	MPlantinExpt-LightItalic
mpisx	MPlantinExpt-SemiBold
mpisix	MPlantinExpt-SemiBoldItalic
mpzr	MPoliphilus
mrurrc	RunicMT-Condensed
msbr	MSabon
msbri	MSabon-Italic
msbs	MSabon-SemiBold
ms1r	MScotchRoman
ms1ri	MScotchRoman-Italic
ms2b	ScriptMT-Bold
msnb4	MSpartan-BoldSizeFour
msnb1	MSpartan-BoldSizeOne
msnb3	MSpartan-BoldSizeThree
msnb2	MSpartan-BoldSizeTwo
msnri4	MSpartan-ItalicSizeFour
msnri1	MSpartan-ItalicSizeOne
msnri3	MSpartan-ItalicSizeThree
msnri2	MSpartan-ItalicSizeTwo
msnr4	MSpartan-SizeFour
msnr1	MSpartan-SizeOne
msnr3	MSpartan-SizeThree
msnr2	MSpartan-SizeTwo
msmr	MSpectrum
msmri	MSpectrum-Italic
msms	MSpectrum-SemiBold
mswb	SwingMT-Bold
msyr	MSymbolPS
mntm	MTimesNewRoman-Medium
mntmi	MTimesNewRoman-MediumItalic
mntrz	MTimesNewRomanCyrillic
mntboz	MTimesNewRomanCyrillic-BolInc
mntbz	MTimesNewRomanCyrillic-Bold
mntroz	MTimesNewRomanCyrillic-Inc
mntrx	MTimesNewRomanExpert
mntbx	MTimesNewRomanExpert-Bold
mntrix	MTimesNewRomanExpert-Italic
mntbix	MTimesNewRomanExpt-BoldItalic
mntrk	MTimesNewRomanGreek
mntbk	MTimesNewRomanGreek-Bold
mntbko	MTimesNewRomanGreek-BoldInc
mntrko	MTimesNewRomanGreek-Inclined
mtmr	MTimesSmallText
mtmb	MTimesSmallText-Bold
mtmii	MTimesSmallText-Italic
mntr	TimesNRMT
mntb	TimesNRMT-Bold
mntbi	TimesNRMT-BoldItalic
mntrrc	TimesNRMT-Condensed
mntbrc	TimesNRMT-CondensedBold
mntric	TimesNRMT-CondensedItalic
mntx	TimesNRMT-ExtraBold
mntri	TimesNRMT-Italic
mnts	TimesNRMT-SemiBold
mntsi	TimesNRMT-SemiBoldItalic
mtwb	MTwentiethCentury-Bold
mtwbrc	MTwentiethCentury-BoldCondensed
mtwbi	MTwentiethCentury-BoldItalic
mtwx	MTwentiethCentury-ExtraBold
mtwxrc	MTwentiethCentury-ExtraBoldCondensed
mtwxi	MTwentiethCentury-ExtraBoldItalic
mtwl	MTwentiethCentury-Light
mtwli	MTwentiethCentury-LightItalic
mtwm	MTwentiethCentury-Medium
mtwmrc	MTwentiethCentury-MediumCondensed
mtwmi	MTwentiethCentury-MediumItalic
mtws	MTwentiethCentury-SemiBold
mtwsm	MTwentiethCentury-SemiMedium
mtwu	MTwentiethCentury-UltraBold
mtwurc	MTwentiethCentury-UltraBoldCondensed
mtwui	MTwentiethCentury-UltraBoldItaic
mtyre	TypewriterEliteMT
mtyrf	TypewriterGothicMT
mtyr	TypewriterMT
mvdr	MVanDijck
mwbr	MWalbaum
mwbri	MWalbaum-Italic
mwbm	MWalbaum-Medium
mwbmi	MWalbaum-MediumItalic
mzar	MZAntiqua
mzab	MZAntiqua-Bold
mzabi	MZAntiqua-BoldItalic
mzari	MZAntiqua-Italic
mzcmi	MZapfChanceryPS-MediumItalic
mzdr	MZapfDingbatsPS
mztrx	ZeitgeistExpertMT
mztbx	ZeitgeistExpertMT-Bold
zmztrxcm	ZeitgeistExpertMT-Cameo
mztrxc	ZeitgeistExpertMT-Condensed
mztix	ZeitgeistExpertMT-Italic
mztr	ZeitgeistMT
mztra	ZeitgeistMT-Alternative
mztb	ZeitgeistMT-Bold
zmztrcm	ZeitgeistMT-Cameo
mztrrc	ZeitgeistMT-Condensed
zmztrcy	ZeitgeistMT-CrazyPaving
mztri	ZeitgeistMT-Italic
